%%%%%%%%
%.    .%
%   P  %
% %%%% %
% %    %
% % %%%%
% %    %
%%%%%%%%
